...................................................................................................................................................................................................................
...................................................................................................................................................................................................................
...................................................................................................................................................................................................................
...................................................................................................................................................................................................................
...................................................................................................................................................................................................................
...................................................................................................................................................................................................................
..................................................................................................................................................................................................<................
......................................................................AA?A............................................................................................................@@..........x................
.....................................................................................................................................................................................@@@..........x................
...................................................AAA.........................AAA?.................................................................................................@@@@..........x................
.............................AAA?..................................................................................AAA.............................................................@@@@@..........x................
.....................................AA?A...........................................A?A?A...Pp..........AA?A..............?....Pp.................................................@@@@@@..........x................
..4................AAA?A................................Pp..........AA?AA...................Tt.................................Tt.................@..............AA?A............@@@@@@@..........x..........KUUK..
.357..................................4.................Tt...Pp...............4.............Tt......@@........Pp...............Tt................@@..Pp.........................@@@@@@@@..........x........BBCVVcBB
12589.........Pp.............4.......357.....Pp.........Tt...Tt..............357............Tt...@@@@@........Tt........4......Tt.............@@@@@..Tt...Pp........@..........@@@@@@@@@..........@........BBCVVcBB
EEEEEEEEEEEEEEEEEEEEEEEEEEEEEEEEEEEEEEEEEEEEEEEEEEEEEEEEEEWWWEEEEEEEEEEEEEEEEEEEEEEEEEEEWWWEEEEEEEEEEEEEEEEEEEEEEEEEEEEEEEEEEEEEEEEEEEWWWEEEEEEEEEEWWEEEEEEEEEEEEEEEEEEEEEEEEEEEEEEEEEEEEEEEEEEEEEEEEEEEEEEEEEEEEEE
EEEEEEEEEEEEEEEEEEEEEEEEEEEEEEEEEEEEEEEEEEEEEEEEEEEEEEEEEEwwwEEEEEEEEEEEEEEEEEEEEEEEEEEEwwwEEEEEEEEEEEEEEEEEEEEEEEEEEEEEEEEEEEEEEEEEEEwwwEEEEEEEEEEwwEEEEEEEEEEEEEEEEEEEEEEEEEEEEEEEEEEEEEEEEEEEEEEEEEEEEEEEEEEEEEE